

			{C,C,C,C,C,C,C,C,C,C,C,C,C,C,C,C,C,C,C,C,C,C,C,C,C,C,C,C,C,C,C,C,C,C,C,C,C,C,C,C},
			{C,C,H,C,C,C,O,O,O,O,O,O,O,O,W,O,O,O,C,C,C,C,C,C,C,C,C,O,O,O,O,O,O,O,O,O,C,C,C,C},
			{C,C,O,C,C,C,O,O,C,C,C,C,C,C,O,C,C,C,O,O,O,H,O,O,O,O,C,C,C,C,C,C,C,C,C,O,O,O,O,C},
			{C,C,O,O,O,O,O,C,C,C,C,C,C,C,O,O,C,C,O,O,C,C,C,C,C,O,O,O,O,O,O,O,O,O,O,O,C,C,O,C},
			{C,C,O,C,C,C,O,O,C,C,C,C,C,C,O,C,C,C,O,C,C,C,C,C,O,C,C,C,C,C,C,C,C,C,O,O,C,C,O,C},
			{C,C,O,O,O,O,O,O,O,O,O,O,O,O,O,O,O,O,O,O,C,C,C,C,C,O,C,C,C,C,C,C,C,C,C,O,C,C,O,C},
			{C,C,O,O,O,O,O,O,O,O,C,C,C,C,C,C,C,C,C,C,C,C,C,C,C,O,O,O,O,O,O,O,O,O,O,O,O,A,O,C},
			{C,C,C,C,C,C,C,C,C,O,C,C,C,C,O,O,O,O,O,O,O,O,O,O,O,C,C,C,O,C,C,C,C,C,C,C,C,C,C,C},
			{C,C,C,C,C,C,C,C,C,O,C,C,C,C,O,O,O,O,O,O,O,O,O,O,O,C,C,C,H,C,C,C,C,C,C,C,C,C,C,C},
			{C,O,O,C,C,C,A,O,O,O,O,O,O,O,O,O,C,C,C,C,C,C,C,C,O,O,O,O,O,O,O,O,O,O,O,O,C,C,C,C},
			{C,O,O,C,C,C,O,C,C,C,O,C,C,C,C,O,C,C,C,O,O,O,O,O,O,O,C,C,C,C,C,C,C,C,C,O,O,O,O,C},
			{C,O,O,O,O,O,O,C,C,C,O,C,C,C,C,O,C,C,C,O,C,C,C,C,C,O,O,O,O,O,C,C,C,C,C,O,C,C,O,C},
			{C,O,O,C,C,C,O,C,C,C,O,C,C,C,C,O,C,C,C,O,C,C,C,C,C,O,C,C,O,O,O,O,A,C,C,O,C,C,O,C},
			{C,O,O,C,C,C,O,O,O,O,O,O,O,O,O,O,O,O,O,O,C,C,C,C,C,O,O,O,O,C,C,C,O,C,C,O,C,C,O,C},
			{C,C,O,O,O,O,O,O,O,O,C,C,C,C,C,O,O,O,O,O,O,O,O,O,C,C,C,O,O,O,O,O,O,O,O,O,O,O,O,C},
			{C,C,H,C,C,C,C,C,C,O,C,C,C,C,C,C,O,C,C,C,C,C,O,C,C,C,C,C,O,O,C,C,C,C,C,O,O,O,C,C},
			{C,C,O,C,C,C,C,C,C,O,C,C,C,C,C,C,O,C,C,C,C,C,O,C,C,C,C,C,O,O,C,C,C,C,C,C,O,O,C,C},
			{C,C,O,O,O,O,O,O,O,O,O,O,O,O,O,O,O,O,O,O,O,O,O,O,O,O,O,O,O,O,O,O,O,O,O,O,O,O,C,C},
			{C,C,O,C,C,C,O,C,C,C,C,C,C,C,C,O,C,C,C,O,O,O,H,O,O,O,C,C,C,C,C,C,C,C,C,O,O,O,O,C},
			{C,C,C,C,C,C,C,C,C,O,C,C,C,C,O,O,O,O,O,O,O,O,O,O,O,C,C,C,O,C,C,C,C,C,C,O,C,C,O,C},
			{C,C,C,C,C,C,C,C,C,O,C,C,C,C,O,O,O,O,O,O,O,O,O,O,O,C,C,C,O,C,C,C,C,C,C,O,C,C,O,C},
			{C,C,O,C,C,C,O,O,O,O,O,O,O,O,O,O,C,C,C,C,C,C,C,C,O,O,O,O,O,O,O,O,O,O,O,O,C,C,O,C},
			{C,C,O,C,C,C,O,C,C,C,C,C,C,C,C,O,C,C,C,O,O,O,O,O,O,O,C,C,C,C,C,C,C,C,C,O,O,O,A,C},
			{C,C,O,O,O,O,O,C,C,C,C,C,C,C,C,O,C,C,C,O,C,C,C,C,C,O,O,O,O,O,C,C,C,C,C,O,C,C,O,C},
			{C,C,O,C,C,C,O,C,C,C,C,C,C,C,C,O,C,C,C,O,C,C,C,C,C,O,C,C,O,O,O,O,O,C,C,O,C,C,O,C},
			{C,C,O,C,C,C,O,O,A,O,O,O,O,O,O,O,O,O,O,O,C,C,C,C,C,O,O,O,O,C,C,C,O,C,C,O,C,C,O,C},
			{C,C,O,O,O,O,O,O,O,O,C,C,C,C,C,O,O,O,O,O,O,O,O,O,C,C,C,O,O,O,O,H,O,O,O,O,O,O,O,C},
			{C,C,O,O,O,O,O,C,C,C,C,C,C,C,C,O,C,O,C,O,C,O,C,O,C,O,O,O,O,O,O,O,O,O,O,O,C,C,O,C},
			{C,C,O,C,C,C,O,C,C,C,C,C,C,C,C,O,C,O,C,O,C,O,C,O,C,O,C,O,C,C,C,C,C,C,C,O,C,C,O,C},
			{C,C,O,C,C,C,O,O,O,O,O,O,O,O,O,O,O,O,C,O,C,O,C,O,C,O,C,O,C,C,C,C,C,C,C,O,C,C,O,C},
			{C,C,A,O,O,O,O,O,O,O,C,C,C,O,C,C,O,O,O,W,O,P,O,W,O,W,O,O,O,O,O,A,O,O,O,O,O,O,O,C},
			{C,C,C,C,C,C,C,C,C,C,C,C,C,C,C,C,C,C,C,C,C,C,C,C,C,C,C,C,C,C,C,C,C,C,C,C,C,C,C,C} 
	O,//open path
	C,//barrier
	A,//apple
	H,//hole
	P,//pig
	W//wolf